 # ###     
 #   #     
 # B #     
 #   #     
## # ######
      #    
# B    HX #
#         #
## #B## X #
 #   # ####
 ### #     